хроматин - хиромант
опрашивание - ошпаривание
гарус - аргус
исповедание - подсеивание
комар - корма
казан - казна
маоист - истома
песчаник - пасечник
свинтус - свистун
метлика - ткемали
пластика - пастилка
акварелист - кавалерист
насильство - навислость
чебачок - бочечка
гамма - магма
пена - пеан
острение - строение
резвушка - зверушка
иноверка - вероника
кромсание - сморкание
туба - табу
задор - зарод
канонада - анаконда
картон - кантор
шёлк - клёш
холоп - плохо
позировка - паровозик
сто - ост
булка - кабул
лайка - кайла
орудование - уродование
славка - свалка
машинка - манишка
нырок - рынок
мала - лама
сабур - бурса
отчинник - ниточник
пробег - погреб
манера - марена
поречная - порченая
арк - акр
соловей - лесовой
всепрощение - воспрещение
невзгодье - гнездовье
спорок - прокос
оселок - колесо
ловушка - валушок
воронко - норовок
двоечник - неводчик
откапывание - покатывание
овин - вино
карета - ракета
мазло - залом
сук - кус
геотермия - геометрия
лерка - карел
лечо - чело
ревность - верность
повар - право
вонища - вощина
поморка - паморок
типчак - птичка
ограниченность - неорганичность
туга - гута
мазочек - замочек
плеск - склеп
саква - вакса
чавкание - чвакание
аймак - кайма
драка - карда
финаль - фалинь
всепрощенец - просвещенец
немка - менка
щетина - нищета
горнист - торгсин
ринк - крин
акмеист - метиска
поскрипывание - попрыскивание
пушник - пуншик
фисташка - фашистка
опал - пола
камора - комара
обвес - обсев
кормач - корчма
опак - капо
инок - кино
трупик - куприт
рамочка - марочка
чара - арча
корма - комар
распивание - спаривание
бинтик - битник
лакуна - уланка
критикан - ракитник
отрок - рокот
лоза - зало
маис - миса
артистка - каратист
склеп - плеск
гнездовье - невзгодье
паморок - поморка
тоска - сотка
кафель - кефаль
откатка - токката
рыдван - надрыв
слиток - листок
высев - вывес
поруха - проуха
струнка - курсант
барон - набор
куфа - фука
стынь - сныть
набатчик - табачник
мазер - замер
локоток - колоток
кавун - внука
морок - ромок
спёртость - пёстрость
обвал - вобла
совик - висок
барекс - сербка
кенотаф - конфета
каркас - краска
малое - омела
аут - тау
лоток - откол
ложа - жало
гнома - манго
кореш - кроше
даргинка - гардинка
пулька - капуль
шельф - флешь
ангар - нагар
кукла - кулак
нок - кон
почка - копач
ельник - никель
туер - руте
силушка - сушилка
клубок - клобук
излом - измол
кратер - картер
высевка - вывеска
ленивая - валяние
номография - монография
мангуст - мустанг
скелет - телекс
собрание - бросание
травушка - ватрушка
кутила - улитка
торф - форт
база - абаз
катрен - танкер
торт - трот
капок - копка
торс - рост
метол - омлет
грядочка - гордячка
олешник - шелоник
кучер - чурек
торн - трон
салопик - сопилка
мадригал - гамадрил
торк - корт
фила - фиал
капот - покат
буксир - срубик
тори - трио
капор - парок
линовка - аквилон
совет - отвес
засмаливание - замасливание
нос - сон
торг - грот
добирание - обдирание
поталь - лапоть
фирма - рифма
петарда - адаптер
пятачок - пяточка
полоток - потолок
каппа - папка
выход - выдох
чаус - усач
подсевка - подвеска
лето - тело
антиквар - тваринка
клапан - планка
перфект - префект
аларма - марала
загребание - разбегание
лобок - колоб
неумойка - ойкумена
китолов - отливок
морячка - армячок
плена - налеп
оркан - крона
матине - метина
надолб - блонда
тортик - ктитор
арника - иранка
ракета - карета
косинус - соусник
лосиха - ослиха
материк - метрика
калан - канал
метис - семит
алкаш - шакал
сотерн - стерно
калач - лачка
куприт - прутик
врач - рвач
приминание - принимание
проминание - пронимание
выборность - обрывность
наречение - нерачение
пьеска - пьекса
купа - паук
чесотка - отсечка
просветитель - терпеливость
малик - милка
ланка - калан
лобик - облик
спаниель - апельсин
начаток - наточка
фанат - нафта
сигнал - салинг
лгунишка - гнилушка
прискочка - скрипочка
разум - мазур
притончик - приточник
алость - сальто
картер - кратер
шпана - панаш
фелон - фенол
втора - автор
отмель - мотель
балык - былка
недотка - анекдот
просевка - провеска
ровнота - новатор
иконка - кокаин
лесопромышленно - солепромышленно
лекарь - келарь
гавана - навага
рассоление - расслоение
нут - тун
лесопромышленни - солепромышленни
интриган - нитрагин
картина - натирка
рутинистка - интуристка
прелина - пралине
обмасливание - обсмаливание
груда - гурда
труба - бурат
ксилит - листик
расслоение - рассоление
слип - плис
слово - волос
сморкание - кромсание
толк - клот
разница - зарница
пророст - простор
пихта - пахит
строгаль - гастроль
халва - валах
нерка - анкер
подсевание - доспевание
свалка - славка
шериф - шифер
подлаивание - допаливание
петрушка - трепушка
корда - дорка
миса - маис
сырца - рысца
чалка - калач
ленч - член
окраина - окарина
капля - пакля
метка - макет
мучка - кумач
кринка - краник
кричание - чиркание
шпала - лапша
проказа - запорка
лосятник - ослятник
скосок - соскок
мирт - ритм
стечение - нечестие
дева - веда
зола - зало
паша - апаш
электрометрия - электротермия
фиск - скиф
накачка - чаканка
ушивка - ивушка
разок - зарок
собина - сбоина
брокат - браток
колун - клоун
пеан - пена
ниточник - отчинник
штурмование - муштрование
комендор - недокорм
ткемали - метлика
развилка - разливка
мослак - сломка
рига - игра
йот - той
капер - репка
гнилуха - хулиган
драга - гарда
плакун - каплун
торнадо - ротонда
отмена - монета
домалывание - доламывание
мотобол - обмолот
ремонт - ментор
барит - триба
пахолок - холопка
бодряк - добряк
тау - аут
иранка - арника
азбука - базука
сокол - колос
черница - арчинец
австриец - царствие
одобрение - ободрение
актирование - откраивание
капуль - пулька
клиент - летник
перетир - репетир
ромок - морок
полдник - плодник
сметанник - наместник
наладка - ладанка
храп - парх
шпатель - штапель
скула - слука
тура - раут
аврал - лавра
ослиха - лосиха
парнишечка - парашечник
принимание - приминание
лесоруб - белорус
полусмерть - пульсометр
турне - унтер
фанза - фазан
хвала - валах
лапушка - плакуша
нанос - анонс
риал - лира
барка - барак
муштрование - штурмование
дора - орда
левизна - вазелин
присев - привес
солод - досол
выточка - отвычка
древо - ведро
есть - сеть
хмара - махра
кулан - лунка
бар - бра
мурашка - мушкара
синкопа - оспинка
спорт - строп
кулак - кукла
милка - малик
раздвоение - дозревание
подущение - допущение
твой - войт
тарбаган - табарган
ишачок - чаишко
рифма - фирма
карга - крага
юхта - тюха
марка - рамка
очанка - чакона
колесо - оселок
добеливание - обделивание
крап - карп
оптика - топика
плохо - холоп
рапс - парс
ресивер - реверси
глава - влага
деловитость - ледовитость
потирание - отпирание
обделивание - добеливание
катерник - каретник
пазанок - запонка
лавчонка - волчанка
неводок - коневод
палочка - лапочка
аорист - сирота
краб - барк
курсант - струнка
базука - азбука
опрощение - поощрение
сачок - косач
макропод - подрамок
рапа - арап
репетир - перетир
дурило - луидор
карда - драка
мечник - немчик
урина - руина
пони - пион
тарист - артист
плотина - полтина
топоним - монотип
потерянность - неопрятность
парсек - каперс
усма - сума
палатин - платина
облик - лобик
лунка - кулан
скрипочка - прискочка
полтинка - лапотник
бурда - будра
переугливание - перегуливание
обмалывание - обламывание
марля - маляр
рвота - автор
рант - натр
волос - слово
омлет - метол
пакля - капля
этернит - энтерит
выступание - спутывание
ель - лье
ногавка - вагонка
карел - лерка
ладанка - наладка
ранг - гран
солемер - ремесло
кабачник - кабанчик
стеночка - станочек
запорка - проказа
репка - капер
мохна - монах
полк - клоп
липочка - пилочка
матрас - сармат
бек - кеб
попрыскивание - поскрипывание
прокашивание - пошаркивание
спилка - клипса
пола - опал
рамс - марс
свистун - свинтус
вопросик - споровик
казна - казан
руководство - куроводство
трепак - паркет
хризотил - хризолит
отопленец - полотенце
шкерт - штрек
опушка - копуша
рама - мара
сваточек - весточка
винодел - недолив
фиксатор - строфика
кипер - пирке
пивоварение - провеивание
уточнение - утончение
чепрак - черпак
клопик - колпик
нанизка - изнанка
обрывность - выборность
дока - кода
комок - мокко
саван - аванс
пяла - паля
рамолик - морилка
пенал - налеп
палестина - пластание
едун - неуд
тёрка - актёр
шезлонг - лонгшез
яишенка - якшание
крона - норка
допущение - подущение
корча - рачок
солодь - сольдо
насмаливание - намасливание
твин - винт
пошаркивание - прокашивание
неводчик - двоечник
интурист - рутинист
накатка - катанка
переслаивание - пересаливание
тик - кит
придаток - подтирка
покатывание - откапывание
рака - арак
белорус - лесоруб
детская - десятка
карат - карта
лавинорез - злонравие
мушар - мураш
бобслей - бейсбол
пимокат - питомка
доилка - кадило
накал - калан
бирка - брика
нива - вина
тукание - кутание
аквилон - линовка
накат - акант
митенка - метинка
мотель - отмель
прокат - тропка
рваньё - враньё
подсев - подвес
набор - барон
начатие - тачание
рулетка - лектура
бистро - сорбит
цоколь - кольцо
хоровик - вихорок
лежание - желание
истопник - синоптик
маляр - марля
сирота - аорист
наказ - казан
дубка - будка
шрам - марш
отдраивание - датирование
канатник - накатник
каган - ганка
мулат - ламут
рогалик - горилка
водогрязелечебн - грязеводолечебн
кагал - галка
токсин - сотник
наследие - седлание
номограмма - монограмма
ситец - истец
марго - могар
ведро - древо
росиночка - сориночка
карелка - лекарка
ножка - кожан
выдох - выход
лиска - силка
рубщик - бурщик
водополь - половодь
задворье - разводье
прокос - спорок
браток - брокат
неофитка - фонетика
рондо - донор
тарификация - ратификация
портище - торпище
кутник - кнутик
ламутка - мулатка
право - повар
лось - соль
кукша - кушак
клот - толк
стояк - остяк
отломок - молоток
клоп - полк
лоск - скол
турбина - трибуна
мазур - мурза
лесишко - селишко
деталь - датель
татарник - тартинка
улитка - кутила
магма - гамма
уздень - зудень
колосок - осколок
маоизм - мимоза
ногата - нагота
слёток - костёл
телескоп - лепесток
битник - бинтик
шкода - дошка
рамка - марка
навага - гавана
наклёп - плёнка
одр - род
кулага - агулка
гурда - груда
проточка - тропочка
колтун - толкун
плюхание - хлюпание
гута - туга
ратификация - тарификация
весна - навес
столик - листок
наветчик - ветчинка
кашне - шнека
отливка - литовка
той - йот
ток - кот
тол - лот
лакрица - карлица
штакор - шторка
отмол - молот
скалозуб - зубоскал
сопель - сельпо
кроки - окрик
неделание - наделение
фиал - фила
глас - галс
кафельщик - факельщик
тепличка - петличка
весок - севок
попас - попса
регион - героин
возлежание - возжелание
подавливание - подваливание
комара - камора
марс - рамс
сопка - скопа
пест - степ
прусик - прикус
уклон - клоун
топонимия - монотипия
дошка - шкода
планида - паладин
стужа - сутаж
летник - клиент
голизна - газолин
корсет - сектор
том - мот
пинок - пикон
зуда - узда
топ - опт
срам - марс
сутаж - стужа
кровное - военкор
катанка - накатка
мазня - знамя
барс - брас
мара - рама
барыня - рабыня
колчан - лончак
тушка - штука
крест - треск
рагу - руга
перш - шерп
барк - брак
вертикаль - кильватер
короб - борок
баркасик - карбасик
перс - репс
чакона - очанка
постилка - скаполит
тиран - ратин
липовка - поливка
школа - лошак
персик - серпик
редизна - дрезина
печальник - чапельник
ситар - сатир
опилка - поилка
терлик - реликт
хлюпание - плюхание
пищание - щипание
смокинг - комингс
тоник - никто
топсель - постель
сократительност - станкостроитель
ямка - маяк
бурак - бурка
военторг - ветрогон
родня - рядно
бадан - банда
санитар - старина
ночка - кочан
ритм - мирт
катание - такание
подсеивание - исповедание
ленчик - членик
фига - гифа
карлица - лакрица
щука - куща
ливенка - великан
кал - лак
кордон - кондор
лосятина - ослятина
кап - пак
кат - акт
вакса - саква
электротермия - электрометрия
плотинка - лапотник
словинец - сонливец
стержень - стрежень
шлюп - плюш
отливок - китолов
баня - баян
прудок - подкур
куща - щука
ристание - стирание
флинта - филант
логика - иголка
бурат - труба
бра - бар
раба - араб
весточка - качество
коневод - неводок
марал - аларм
сиволапость - опасливость
хористка - акростих
сурьма - усмарь
гардинка - градинка
каверза - заверка
прима - ампир
горка - кагор
концертант - концентрат
тёлка - лётка
омела - малое
крага - карга
ледовитость - деловитость
тук - кут
тун - нут
пахта - птаха
фракиец - циферка
вызов - вывоз
галка - кагал
овчарник - чаровник
допревание - продевание
наливка - лавинка
река - каре
гарант - гранат
соглас - глосса
марочка - рамочка
скора - окрас
колосик - соколик
добро - бордо
паротит - патриот
доступ - подуст
дояр - ядро
носкость - косность
осинка - косина
верба - абвер
окладка - докалка
контур - котурн
сонетка - сотенка
грибок - горбик
птаха - пахта
лекарка - карелка
дарение - драение
туф - фут
сима - маис
свитка - сватик
скопа - сопка
отпор - порто
марочник - рамочник
ниша - шина
туя - утя
дудка - дудак
орда - дора
графология - голография
плакатист - пластикат
ивушка - ушивка
кеб - бек
молка - ломка
наивничание - начинивание
прекос - просек
бязь - зябь
сотка - тоска
бочечка - чебачок
оперетка - перетока
кабанчик - кабачник
копир - пирок
ресница - серница
отмалывание - отламывание
вариант - травина
дротик - диктор
пирок - копир
кавальер - акварель
сила - лиса
заманка - мазанка
испуг - пигус
рутинист - интурист
трескотня - стрекотня
бук - куб
укор - урок
валяние - ленивая
колба - балок
срубик - буксир
спиртомер - спирометр
злое - зело
тесинка - астеник
компостер - термоскоп
кутас - скаут
вобла - обвал
агулка - калуга
панаш - шпана
кража - жарка
рамочник - марочник
вдох - вход
маяние - анемия
бордо - добор
томан - манто
крот - корт
надир - динар
талик - литка
кенар - анкер
копка - капок
макси - миска
киношка - конишка
стрежень - стержень
театрик - кератит
кастор - костра
образчик - заборчик
наводнение - невиданное
пигус - испуг
скотина - остинка
сектор - корсет
ведерница - нерадивец
ваер - вера
срубка - барсук
ярд - ряд
петлица - теплица
половодье - водополье
черепица - печерица
плёнка - наклёп
рачонок - норочка
дурочка - дочурка
мета - тема
канатчик - накатчик
паркет - трепак
балет - лабет
подвержение - повреждение
понимание - поминание
докер - декор
лозинка - анкилоз
оникс - носик
мастика - аксамит
дерма - дрема
кил - лик
селище - лесище
орс - сор
шифер - шериф
ампула - амплуа
вход - вдох
опт - пот
зенитка - казинет
сфалерит - фалерист
меря - ярем
сумма - самум
чепрачок - черпачок
альков - коваль
лихость - хилость
пронесение - опреснение
пурка - крупа
конишка - киношка
лупа - паул
такальщик - катальщик
танагра - граната
чёбот - обчёт
размол - разлом
рента - антре
патанка - каптана
пойло - полой
талес - стела
лонгшез - шезлонг
ост - сот
орт - рот
окрас - скора
пирке - кипер
кабул - булка
плита - пилат
намотчик - маточник
шишка - шишак
сумка - камус
уторка - кутора
синематограф - магнитосфера
клёш - шёлк
вокал - валок
загон - газон
лесище - селище
шарм - марш
дергун - недруг
москит - мостик
лунь - нуль
шарф - фарш
опасливость - сиволапость
педолог - логопед
тачание - начатие
тёзка - затёк
простата - пасторат
пирит - иприт
литовка - отливка
уборка - кобура
кантор - картон
таракан - таранка
тыква - выкат
кредитор - директор
катерна - ранетка
чиновник - овчинник
прослаивание - просаливание
симка - макси
насосик - инкассо
окнище - конище
выламывание - вымалывание
мякина - яминка
спина - псина
неорганичность - ограниченность
врезывание - вызревание
отборка - обротка
рысца - сырца
осмогласие - семасиолог
рынок - нырок
разминание - разнимание
отдаривание - датирование
иголка - логика
богач - бочаг
перенимание - переминание
тавро - автор
распиливание - присаливание
костра - кастор
крин - ринк
булочник - лубочник
овёс - своё
вёрстка - свёртка
кефаль - кафель
колосочек - осколочек
луидор - дурило
гостинка - агностик
вешка - векша
добрячок - бодрячок
букан - бакун
шебека - бекеша
галерник - лагерник
дагерротипия - гидротерапия
монограмма - номограмма
плодник - полдник
копал - полка
прибавок - пробивка
верста - стерва
соринка - росинка
курбет - беркут
поздника - поднизка
тупец - путец
сруб - брус
пахит - пихта
десятка - детская
повеса - пасево
парнишка - парашник
пропарщица - прапорщица
интересное - нестроение
московит - мостовик
пальто - лапоть
торба - аборт
пальтишко - платьишко
копач - почка
лавинщик - наливщик
код - док
осман - масон
плотичка - плиточка
грядиль - дрягиль
невод - девон
заточка - зачаток
ложечка - лежачок
вноска - сновка
садок - доска
атаман - аманат
ракетостроение - катеростроение
чепанчик - пачечник
кот - ток
тапир - пират
селитра - реалист
кнутик - кутник
дудак - дудка
зубоскал - скалозуб
сторица - острица
анемия - маяние
перевес - пересев
норовок - воронко
синоптик - истопник
делянка - ледянка
марена - манера
кинозал - анкилоз
поилка - опилка
глосса - соглас
отпал - плато
коробка - барокко
пластикат - плакатист
низка - кинза
отцепка - капотец
нерачение - наречение
пасторат - простата
рачок - корча
каприз - приказ
карбасик - баркасик
бросок - собкор
неблагорасполож - благорасположен
чаканка - накачка
ледянка - делянка
драение - дарение
рядно - родня
апаш - паша
зверушка - резвушка
внука - кавун
крен - керн
винт - твин
кош - шок
серпок - прекос
прилов - пролив
вино - воин
рубка - бурак
вина - нива
плиска - клипса
барокко - коробка
кишлак - шкалик
благорасположен - неблагорасполож
плиточка - плотичка
раус - сура
выпрашивание - вышпаривание
трибуна - турбина
аскер - серка
аскет - секта
киста - такси
лодка - оклад
холопка - пахолок
абрек - бекар
пост - стоп
настроение - остранение
кси - икс
бекеша - шебека
маяк - ямка
корпус - прокус
просев - провес
скрепа - каперс
черпачок - чепрачок
черпак - чепрак
гамадрил - мадригал
скоба - басок
подкова - паводок
просек - прекос
лагун - галун
макет - метка
добор - бордо
неопрятность - потерянность
баян - баня
клеть - кельт
сныть - стынь
метиска - акмеист
отвес - отсев
порт - троп
оскабливание - обласкивание
лишек - клише
солепромышленно - лесопромышленно
куртка - крутка
недосев - недовес
лузга - загул
солепромышленни - лесопромышленни
кранец - канцер
катион - аконит
розга - гроза
нотка - танок
аз - за
веда - дева
кварта - травка
кус - сук
кут - тук
ватник - квинта
ромб - бром
осколочек - колосочек
прапорщик - пропарщик
стоик - исток
галоид - диалог
куб - бук
изнанка - нанизка
травинка - антиквар
гарда - драга
плис - слип
талыш - латыш
краник - кринка
аргон - онагр
бекар - абрек
просаливание - прослаивание
фалерист - сфалерит
лапотник - лопатник
каплун - плакун
подсока - подоска
снет - стен
пансион - сапонин
трио - тори
сама - саам
возжелание - возлежание
намотка - комната
раскат - старка
обламывание - обмалывание
подлетание - доплетание
пшат - шпат
комингс - смокинг
перелом - перемол
ивка - вика
соление - слоение
сминание - снимание
вес - сев
гарем - герма
кукан - кунак
морда - домра
анкилоз - кинозал
простор - пророст
ускок - кусок
шкаторина - картошина
пантовар - аванпорт
тарель - артель
прелат - талреп
семит - метис
фототелеграфия - телефотография
натасчик - станичка
покат - капот
анаконда - канонада
клоповник - полковник
утоп - путо
поставец - повестца
утор - утро
орун - руно
подмасливание - подсмаливание
лисогон - синолог
жало - ложа
растение - старение
замочек - мазочек
размалывание - разламывание
тропа - апорт
стоянка - скотная
каблучник - клубничка
кипа - пика
мулатка - ламутка
кошма - мокша
рикша - шарик
синап - псина
скаполит - постилка
судок - скудо
марала - аларма
пас - сап
расшаркивание - раскрашивание
шина - ниша
альбом - мольба
жако - кожа
оплата - лопата
ядро - дояр
микадо - доимка
фазан - фанза
такание - катание
полировка - приволока
спутывание - выступание
треф - ферт
сайра - сарай
талька - каталь
логопат - патолог
копун - купон
пак - кап
трен - терн
бросание - собрание
утро - утор
остинка - скотина
полотенце - отопленец
кино - инок
низочка - заочник
передаривание - передраивание
конфета - кенотаф
таран - нарта
ер - ре
висок - совик
чело - лечо
опаска - пасока
барсук - бурсак
скудо - судок
вид - див
аларм - марал
аргус - гарус
серпик - персик
плато - отпал
барак - барка
топика - оптика
гаврик - гривка
плата - лапта
травина - вариант
супник - пискун
тиранка - картина
за - аз
рыбка - рыбак
минтай - наймит
просов - вопрос
путо - утоп
насос - сосна
вабик - бивак
колоб - лобок
мостик - москит
туша - ушат
натр - рант
никель - ельник
наварка - караван
образец - заборец
ржица - жрица
рогатка - каторга
колос - сокол
полутон - лопотун
османка - масонка
фортка - фактор
шкала - алкаш
логопед - педолог
кика - каик
морг - гром
наст - стан
ранетка - катерна
аптечка - печатка
костёл - слёток
загул - лузга
серка - аскер
опреснение - пронесение
канцер - кранец
гром - морг
патриот - паротит
мошка - кошма
седёлка - селёдка
шарик - рикша
гроб - горб
каретник - катерник
строка - кастор
пялка - капля
циферка - фракиец
плаз - залп
присаливание - распиливание
трубоукладчик - буртоукладчик
гроза - розга
зарод - задор
куржак - кружка
харкота - картоха
астеник - тесинка
норочка - рачонок
доимка - микадо
трепушка - петрушка
спирометр - спиртомер
просадка - парадокс
накожник - книжонка
товарка - автокар
замер - мазер
шишак - шишка
замес - сезам
песчинка - пасечник
колик - клико
стена - сенат
станочек - стеночка
трак - карт
ручка - круча
тьма - мать
накатчик - канатчик
шнека - кашне
дура - даур
сватик - свитка
соперник - пироксен
шляпочка - пошлячка
сольдо - солодь
латинка - талинка
адаптер - петарда
заточник - затончик
слепень - плесень
наточка - начаток
фара - арфа
ли - ил
хиромант - хроматин
каупер - укрепа
приточник - притончик
вор - ров
таган - агнат
кокора - окорка
могар - марго
репс - перс
подсачок - подсочка
роман - норма
загончик - газончик
проламывание - промалывание
романчик - марочник
пехота - потеха
торпище - портище
строповка - костоправ
окарина - окраина
ля - ял
фарш - шарф
дранка - кардан
навислость - насильство
выбойка - баковый
стела - талес
актёр - тёрка
воз - зов
галун - лагун
вол - лов
сбоина - собина
чвакание - чавкание
коршун - шнурок
активация - кавитация
строение - острение
автокар - отварка
му - ум
фонетика - неофитка
подтирка - придаток
лаж - лжа
осмол - мосол
лаз - зал
пустошка - пастушок
телекс - скелет
откраивание - актирование
лак - кал
стека - аскет
донкихот - отходник
газон - загон
жабо - обжа
скнипа - спинка
спаривание - распивание
борок - короб
но - он
армячок - морячка
ледоруб - ледобур
саам - сама
кутание - тукание
исподка - диаскоп
горбик - грибок
балок - бокал
ламут - мулат
великан - ливенка
милачок - милочка
пиромантия - патронимия
светобоязнь - обезьянство
клоун - колун
онагр - аргон
стропа - пастор
менка - немка
он - но
утя - туя
монета - немота
окрик - кроки
поленище - площение
пула - лупа
бытование - отбывание
штопорение - потрошение
дуло - одул
моделист - мелодист
надой - дойна
обсмаливание - обмасливание
ледничек - леденчик
пяточка - пятачок
внимание - вминание
рванина - нирвана
гриб - бриг
зарок - разок
монография - номография
аванпорт - пантовар
отпуст - отступ
юкка - каюк
покраска - раскопка
колет - леток
антимир - мартини
треск - крест
колер - креол
реле - леер
мрамор - мармор
обмолот - мотобол
термит - метрит
спица - псица
кармазин - разминка
ре - ер
дочурка - дурачок
рыбак - рыбка
малодойка - молодайка
виляние - влияние
ватрушка - травушка
опадение - поедание
диктор - дротик
обводка - добавок
кортома - моторка
солодка - досолка
педология - логопедия
разлом - размол
топка - капот
приволока - полировка
разбегание - загребание
патология - логопатия
паводок - подкова
водица - двоица
пастушок - пустошка
стан - наст
ослятник - лосятник
подоска - подсока
акростих - хористка
неуд - едун
владение - давление
укрепа - каупер
штукарка - картушка
добряк - бодряк
прослоек - пролесок
став - сват
ослик - силок
киприот - ипокрит
повеление - полевение
су - ус
прорва - провар
концентрат - концертант
лжа - лаж
ропак - капор
прапорщица - пропарщица
силок - ослик
зубатка - забутка
кинизм - зимник
отламывание - отмалывание
потрава - правота
синолог - лисогон
шток - кошт
подрамок - макропод
птичка - типчак
костоправ - строповка
скаут - кутас
явление - вяление
топик - оптик
пачечник - чепанчик
точилка - отличка
бином - обмин
руда - даур
печерица - черепица
абвер - верба
лучок - чулок
новь - вонь
вывес - высев
прах - парх
карп - крап
мура - муар
пряха - хряпа
сорбит - бистро
отходник - донкихот
промалывание - проламывание
доспевание - подсевание
пот - опт
ветрище - вретище
каре - река
кацап - цапка
двоица - водица
ум - му
кара - арак
вест - свет
членик - ленчик
ус - су
каустик - акустик
кельт - клеть
руга - рагу
дурак - дурка
дурачок - дочурка
ломик - милок
угар - рагу
драп - пард
мимоза - маоизм
градирование - драгирование
девон - невод
наилок - каолин
векша - вешка
лапша - палаш
гифа - фига
горбок - гробок
капо - копа
считка - частик
часок - косач
дурника - дуринка
лик - кил
кавалерист - акварелист
сцеп - спец
ударник - дуринка
леток - колет
лопата - оплата
рвач - врач
усмарь - сурьма
гонение - гноение
картушка - штукарка
отдаивание - дотаивание
просевание - воспарение
ступка - пустка
член - ленч
строфика - фиксатор
пси - сип
граната - танагра
сонливец - словинец
обдуривание - будирование
рысь - сырь
подвода - водопад
вера - ваер
платоник - лапотник
просо - опрос
унисон - нониус
парашечник - парнишечка
протечка - трепачок
анекдот - недотка
зал - лаз
зам - маз
ипокрит - киприот
свевание - всевание
сколка - склока
антик - нитка
майка - аймак
сомье - мосье
порыв - выпор
севр - серв
дрягиль - грядиль
нагар - ангар
старка - раскат
номарх - монарх
нищета - тщание
тимошка - мотишка
кант - танк
отбор - робот
табун - банту
волокитство - китоловство
лапта - плата
хасид - хадис
черва - вчера
арка - арак
шнурок - коршун
пырскание - прыскание
отказ - заток
лучик - кулич
каста - такса
гноение - гонение
секта - аскет
фенол - фелон
кедрач - чердак
пилат - плита
сечка - секач
повреждение - подвержение
буртоукладчик - трубоукладчик
кавычка - выкачка
плюшка - шлюпка
донор - рондо
неразумие - разумение
тщание - нищета
двоечка - девочка
пробивка - прибавок
автопарк - отправка
сармат - матрас
картоха - харкота
пластырь - псалтырь
силка - лиска
ливан - налив
рококо - окорок
журка - кураж
трус - руст
труп - прут
манто - томан
гардина - градина
манишка - машинка
отбывка - бытовка
пипка - пикап
бурщик - рубщик
редан - дрена
забутка - зубатка
мармор - мрамор
филант - флинта
старик - стирка
острица - сторица
цапка - кацап
лубочник - булочник
талреп - прелат
лопатка - отпалка
отпирание - потирание
ладошка - лошадка
распадок - парадокс
вывеска - высевка
ромашка - мошкара
тесак - аскет
ампир - прима
норов - ворон
како - кока
энтерит - этернит
тонирование - нотирование
золка - закол
ратин - тиран
кольцо - цоколь
затёк - тёзка
пастор - стропа
качество - весточка
уродование - орудование
жеребок - бережок
уланка - лакуна
ободрение - одобрение
лог - гол
стопорение - построение
рокот - отрок
дублирование - дорубливание
заочник - низочка
равновесие - своенравие
лом - мол
отпаривание - протаивание
струп - спрут
датирование - отдаривание
мостовик - московит
акробат - работка
лот - тол
отступ - отпуст
враньё - рваньё
копуша - опушка
нестроение - интересное
табор - аборт
конкиста - скотинка
скало - оскал
альт - таль
вредность - древность
реверси - ресивер
запонка - пазанок
пришивка - паршивик
куранта - натурка
пуншик - пушник
лов - вол
старорежимность - нерасторжимость
типометр - оптиметр
подкапок - подкопка
каик - кика
собкор - бросок
станкостроитель - сократительност
старение - растение
обрыв - выбор
добавок - обводка
раскрашивание - расшаркивание
лектура - рулетка
дрезина - редизна
равнина - нирвана
триада - тирада
доска - садок
пастилка - пластика
пшик - шпик
остранение - настроение
поедание - опадение
ситчик - чистик
рост - сорт
токката - откатка
цветничок - цветочник
патронимия - пиромантия
пилочка - липочка
манок - манко
подкур - прудок
бытовка - отбывка
моторка - кортома
помол - полом
надкалывание - накладывание
упорность - понурость
гам - маг
казачка - закачка
акант - канат
торопливость - ропотливость
линкос - слоник
подворник - проводник
трот - торт
трос - рост
просящий - спорящий
троп - порт
крипта - притка
нечестие - стечение
трико - ротик
норка - крона
трон - торн
мания - ямина
трок - корт
водополье - половодье
тропник - криптон
аксон - носка
смутка - мускат
лизоблюд - блюдолиз
арго - гора
трог - грот
табло - блато
канал - калан
воспарение - просевание
коляска - ясколка
креозот - отрезок
вкуснотища - установщик
канат - акант
наделение - неделание
ашуг - шуга
водоток - отводок
репринт - принтер
дернина - реднина
логик - голик
прыскание - пырскание
поливка - липовка
строп - спорт
вилка - валик
налив - ливан
горчинка - органчик
кочегар - кочерга
лавра - аврал
смолка - мослак
сориночка - росиночка
мандраж - жандарм
таранка - таракан
налим - лиман
ловитор - творило
желание - лежание
проза - запор
дружество - дежурство
норма - роман
клише - лишек
досол - солод
ял - ля
дизайн - задний
мошкара - ромашка
никто - тоник
брика - бирка
поломка - помолка
арат - тара
лапка - палка
ротонда - торнадо
арба - араб
продубка - подрубка
обмол - облом
луг - гул
донец - донце
кокаин - иконка
риска - искра
рожак - жарок
араб - арба
арап - пара
оптиметр - типометр
потрошение - штопорение
арак - арка
манко - манок
порто - отпор
слоник - линкос
шелоник - олешник
фука - куфа
товар - автор
листок - слиток
прикатка - практика
подвеска - подсевка
ремиз - мизер
ливанка - лавинка
солевоз - лесовоз
пекан - пенка
упрочение - поручение
штрек - шкерт
чурбак - барчук
стоечка - отсечка
прокучивание - покручивание
сезам - замес
шпора - апрош
раздаивание - задаривание
зало - зола
окорок - рококо
залп - плаз
спинка - скнипа
немота - монета
пират - тапир
милочка - милачок
соиздатель - созидатель
лепесток - телескоп
тропка - прокат
липа - пила
стапель - пастель
шок - кош
бережок - жеребок
древесница - сердцевина
ренегат - реагент
масонка - османка
соломка - осмолка
доламывание - домалывание
метрика - материк
графа - аграф
ослятина - лосятина
тропик - портик
портер - претор
ментор - ремонт
агнец - ганец
спрут - спурт
народ - радон
ферт - треф
кокос - косок
анонс - нанос
анкер - кенар
флешь - шельф
зов - воз
фатум - муфта
испанка - писанка
отбывание - бытование
свиточек - советчик
потолок - полоток
носка - аксон
кератит - театрик
привес - присев
дромадер - дромедар
шутка - тушка
мокша - кошма
портик - приток
кадило - доилка
нарта - таран
реднина - дернина
тропина - атропин
метина - матине
претор - портер
раб - бар
кинза - низка
старикан - канистра
фалинь - финаль
акварель - кавальер
раж - жар
тенор - терно
провеска - просевка
обделка - добелка
сковка - квасок
сопилка - салопик
кусок - ускок
ветрогон - военторг
ролик - орлик
старина - санитар
ипокритка - киприотка
сток - скот
нитрагин - интриган
караван - наварка
капонир - опарник
минор - мирон
ропот - отпор
площение - поленище
выпор - порыв
ямина - мания
игла - лига
толпа - отпал
фетр - треф
архаизм - харизма
носик - оникс
табачник - набатчик
насаливание - наслаивание
капюшон - понюшка
знамя - мазня
гидротерапия - дагерротипия
оклик - клико
прикус - прусик
штурмовка - муштровка
газолин - голизна
своенравие - равновесие
окорка - кокора
руте - туер
разламывание - размалывание
паршивик - пришивка
протаивание - отпаривание
погреб - пробег
стационар - соратница
кабан - банка
рута - раут
надрыв - рыдван
кунак - кукан
адрес - среда
муаре - урема
чистка - считка
апрош - шпора
руст - трус
залом - мазло
бакун - букан
патолог - логопат
ирга - игра
липка - пилка
сеть - есть
оптик - питок
лесовой - соловей
ластик - стилка
лесовоз - солевоз
перетока - оперетка
склока - сколка
просвещенец - всепрощенец
тамариск - матрасик
чумак - кумач
подвес - подсев
обтирание - отбирание
подсочка - подсачок
дрок - корд
раскопка - покраска
мазилка - алмазик
платина - палатин
сельпо - сопель
закачка - казачка
автор - втора
отвар - автор
фоника - факино
овчинник - чиновник
вымалывание - выламывание
отвал - автол
влага - глава
фтор - торф
рубщица - бурщица
петличка - тепличка
факир - фиакр
автол - отвал
тартинка - татарник
выкачка - кавычка
чистик - ситчик
перхание - храпение
подсмаливание - подмасливание
бачок - бочка
кочерга - кочегар
выкрашивание - вышаркивание
перегуливание - переугливание
рабыня - барыня
самум - сумма
седлание - наследие
чурек - кучер
монарх - номарх
валушок - ловушка
метинка - митенка
заборец - образец
агнат - таган
накатник - канатник
война - навой
корчма - кормач
кротовина - тонировка
курник - крикун
адат - дата
дереза - резеда
нагул - галун
ржа - жар
потачка - тапочка
серп - перс
лье - ель
откол - лоток
бестер - берест
кильватер - вертикаль
серв - севр
кедр - дрек
биток - ботик
кобура - уборка
разумение - неразумие
вонь - новь
сингал - салинг
каталь - талька
биатлонист - линобатист
чаровник - овчарник
салинг - сигнал
такси - киста
желатин - желтина
балобан - балабон
голик - логик
руно - орун
зарница - разница
фактор - фортка
асцит - циста
шрамик - маршик
чердак - кедрач
пелеринка - крапление
табу - туба
гол - лог
ботаник - каботин
киприотка - ипокритка
плакирование - прокаливание
терние - трение
руна - урна
оспа - сопа
лазок - закол
присмаливание - примасливание
латышка - талышка
такса - каста
понюшка - капюшон
арча - чара
маг - гам
водосток - скотовод
зачаток - заточка
лежачок - ложечка
севок - весок
пионерка - кропание
каторга - рогатка
ушат - туша
паровозик - позировка
год - дог
агностик - гостинка
корвет - вектор
мах - хам
парок - капор
терпеливость - просветитель
ветчинка - наветчик
дуринка - дурника
бутан - банту
нафта - фанат
интуристка - рутинистка
вывоз - вызов
просвещение - воспрещение
маз - зам
героин - регион
драгирование - градирование
пасево - повеса
рис - сир
цветочник - цветничок
катар - карат
обтачка - табачок
пахание - хапание
чурка - круча
кочан - ночка
парубок - порубка
сеточка - отсечка
икона - инока
талинка - латинка
перемалывание - переламывание
плюш - шлюп
парашник - парнишка
порубка - парубок
харизма - архаизм
работка - акробат
сербка - барекс
кожан - ножка
искра - риска
невиданное - наводнение
одул - дуло
термоскоп - компостер
каботин - ботаник
присасывание - расписывание
степ - пест
храпение - перхание
стен - снет
топор - отпор
пенсионерка - покраснение
пудель - дупель
кряжина - жирянка
оклад - лодка
тропочка - проточка
лига - игла
якшание - яишенка
лгунья - гульня
перемол - перелом
мга - гам
антре - ранет
арфа - фара
войт - твой
штапель - шпатель
вяление - явление
яминка - мякина
запор - проза
мокко - комок
пестик - септик
сапонин - пансион
трюк - тюрк
стирка - старик
поминание - понимание
промол - пролом
лексикон - колесник
изламывание - измалывание
миска - макси
покручивание - прокучивание
мелодист - моделист
немчик - мечник
планка - клапан
сосна - насос
сотенка - сонетка
воин - вино
баковый - выбойка
лазка - закал
шерп - перш
фут - туф
ломка - молка
обсев - обвес
контра - кантор
апломб - пломба
дурка - дурак
каптана - патанка
амплуа - ампула
задаривание - задраивание
линобатист - биатлонист
недолив - винодел
рысак - крыса
дрек - кедр
артист - тарист
скитание - тискание
узда - зуда
психопатология - патопсихология
допаливание - подлаивание
краина - арника
ямочка - маячок
донце - донец
истома - маоист
скотная - стоянка
гул - луг
кайла - лайка
клипса - плиска
кардинал - ирландка
ров - вор
род - одр
низанка - изнанка
пилка - липка
подуст - доступ
самка - камса
канадец - каденца
ром - мор
бурсак - барсук
кайма - аймак
свёртка - вёрстка
хадис - хасид
шлюпка - плюшка
дойна - надой
форт - торф
тамарикс - матрасик
ягуар - яруга
обрат - аборт
сновка - вноска
дельта - датель
провес - просев
бантик - батник
воспрещение - всепрощение
разнимание - разминание
дорубливание - дублирование
пустка - ступка
образ - забор
сукно - конус
циста - асцит
всевание - свевание
вышаркивание - выкрашивание
рот - орт
катальня - тальянка
отара - аорта
сват - став
эпатирование - этапирование
утончение - уточнение
гнилушка - лгунишка
удар - даур
лосёнок - ослёнок
свал - влас
торгсин - горнист
крутка - куртка
трепачка - перчатка
недовес - недосев
герб - брег
салатник - настилка
травка - кварта
вретище - ветрище
мушкара - мурашка
перчатка - трепачка
лапоть - пальто
басок - скоба
вектор - корвет
накладывание - надкалывание
шпик - пшик
валет - ветла
танок - нотка
слоение - соление
анид - дина
латыш - талыш
просмаливание - промасливание
резка - резак
пломба - апломб
пробирка - приборка
сырь - рысь
писк - скип
подопревание - проповедание
ракитник - критикан
обжа - жабо
хризолит - хризотил
навес - весна
опарник - капонир
мольба - альбом
переминание - перенимание
ранет - антре
скот - сток
практика - прикатка
валик - вилка
скол - лоск
нуль - лунь
пропитывание - притопывание
скок - кокс
казинет - зенитка
макаронник - накомарник
косок - кокос
лама - мала
ботик - биток
рачение - наречие
келарь - лекарь
пикап - пипка
пироксен - соперник
повозка - павозок
кока - како
накра - аркан
растушка - старушка
гранат - гарант
амбар - амбра
капотец - отцепка
отец - оцет
гусар - аргус
монотип - топоним
сеянец - ясенец
бриг - гриб
початок - топочка
фиакр - факир
парадокс - просадка
расписывание - присасывание
чулок - лучок
утлегарь - ругатель
водопад - подвода
скотовод - водосток
валка - лавка
пион - пони
осмолка - соломка
вероника - иноверка
девочка - двоечка
намазка - заманка
нистагм - гимнаст
криптон - тропник
семитка - акмеист
замасливание - засмаливание
маршик - шрамик
банка - кабан
орлик - ролик
доплетание - подлетание
прокус - корпус
лончак - колчан
натирка - картина
искрашивание - исшаркивание
нерасторжимость - старорежимность
нитка - антик
павозок - повозка
ланита - талина
реактив - тиверка
ловчак - ловкач
прикрашивание - пришаркивание
факельщик - кафельщик
питок - оптик
снимание - сминание
реалист - селитра
радон - народ
салотоп - апостол
фермата - марафет
мураш - мушар
кулон - клоун
антимония - антиномия
поддабривание - подбадривание
провар - прорва
проводник - подворник
каолин - наилок
полтина - плотина
срастание - расстание
оскал - скало
подбадривание - поддабривание
мол - лом
установщик - вкуснотища
ветла - валет
отклик - клотик
дозревание - раздвоение
апостол - салотоп
дина - анид
мор - ром
заметка - каземат
плесень - слепень
семасиолог - осмогласие
измол - излом
усач - чаус
натурка - куранта
потеха - пехота
питомка - пимокат
дромедар - дромадер
измалывание - изламывание
кропание - пионерка
навар - варан
карта - карат
хам - мах
кожа - жако
среда - адрес
хан - хна
колесник - лексикон
трение - терние
реликт - терлик
инкассо - насосик
накомарник - макаронник
акваплан - наплавка
пересмаливание - перемасливание
мот - том
пила - липа
дежурство - дружество
примасливание - присмаливание
бурка - бурак
ганец - агнец
виола - олива
задраивание - задаривание
ситце - истец
облом - обмол
подваливание - подавливание
сопревание - воспарение
осколок - колосок
скиф - фиск
зерно - резон
ругатель - утлегарь
помолка - поломка
пролеска - лесопарк
скип - писк
сорт - рост
патопсихология - психопатология
верейка - еврейка
былка - балык
полой - пойло
серница - ресница
кандиль - льдинка
полом - помол
пике - кепи
кроше - кореш
штука - тушка
кулич - лучик
царствие - австриец
пика - кипа
танкер - катрен
пересев - перевес
скотинка - конкиста
барчук - чурбак
кода - дока
красотка - касторка
дрена - редан
чиркание - кричание
желтина - желатин
мотишка - тимошка
построение - стопорение
честолюбие - любочестие
апорт - тропа
вчера - черва
драгировка - градировка
сопа - оспа
каретка - ракетка
пенка - пекан
тотем - мотет
куроводство - руководство
патронник - пантокрин
мосол - осмол
керамзит - маркизет
табарган - тарбаган
верность - ревность
станичка - натасчик
акустик - каустик
тальянка - катальня
котурн - контур
плакуша - лапушка
тара - арат
дрема - дерма
крапление - пелеринка
опрос - просо
вышпаривание - выпрашивание
сломка - мослак
органчик - горчинка
икс - иск
хулиган - гнилуха
проповедание - подопревание
затончик - заточник
тапочка - потачка
брас - барс
магнитосфера - синематограф
отсечка - сеточка
продевание - допревание
селёдка - седёлка
лакей - лейка
мизер - ремиз
брак - барк
валах - халва
керн - крен
каденца - канадец
исшаркивание - искрашивание
наволок - коновал
топочка - початок
щипание - пищание
аграф - графа
﻿ропотливость - торопливость
оцет - отец
мартини - антимир
стерва - верста
нерадивец - ведерница
фрау - фура
ганка - каган
горбатая - работяга
леденчик - ледничек
ловкач - ловчак
дорка - корда
порочность - чопорность
уход - худо
каганат - таганка
лавинка - ливанка
нагота - ногата
пришаркивание - прикрашивание
пролесок - прослоек
газончик - загончик
попса - попас
румба - умбра
милок - ломик
отсев - отвес
логопатия - патология
продувка - пудровка
полка - копал
факино - фоника
намасливание - насмаливание
подкопка - подкапок
ситро - сорит
пастель - стапель
трепачок - протечка
кепи - пике
гробик - горбик
созидатель - соиздатель
худо - уход
резак - резка
слука - скула
соль - лось
танк - кант
отличка - точилка
сушилка - силушка
католичка - калиточка
кагор - горка
таска - каста
кариб - бирка
обчёт - чёбот
стирание - ристание
стук - куст
вопрос - просов
бурса - сабур
удол - дуло
метрит - термит
наслаивание - насаливание
игра - ирга
лагерник - галерник
ухарство - воструха
скерда - скаред
унтер - турне
косач - сачок
путец - тупец
купон - копун
понурость - упорность
калиточка - католичка
рубильщик - бурильщик
телок - колет
талина - ланита
таль - альт
детка - кадет
голография - графология
кушак - кукша
паладин - планида
вазелин - левизна
книжонка - накожник
лира - риал
банда - бадан
муштровка - штурмовка
монах - мохна
шкалик - кишлак
досолка - солодка
каземат - заметка
клобук - клубок
притопывание - пропитывание
прут - труп
сап - пас
лейка - лакей
нервоз - невроз
налеп - пенал
мотет - тотем
аманат - атаман
листовка - вокалист
пятак - пятка
соратница - стационар
атропин - тропина
обласкивание - оскабливание
зимник - кинизм
наплавка - акваплан
сотник - токсин
обмин - бином
ошпаривание - опрашивание
псица - спица
ряд - ярд
паук - купа
бурильщик - рубильщик
каратист - артистка
паул - лупа
покраснение - пенсионерка
жирянка - кряжина
льдинка - кандиль
пролив - прилов
канистра - старикан
градинка - гардинка
даур - дура
мышка - камыш
катеростроение - ракетостроение
дотаивание - отдаивание
камыш - мышка
повестца - поставец
добелка - обделка
вазон - навоз
отводок - водоток
совпадение - доспевание
вагонка - ногавка
арапник - крапина
бочаг - богач
сарай - сайра
шкот - кошт
рация - ярица
вызревание - врезывание
давление - владение
старинка - канистра
абаз - база
датель - дельта
иск - икс
листик - ксилит
полевение - повеление
номад - домна
жарок - рожак
мазанка - заманка
тяпка - пятак
шторка - штакор
аксамит - мастика
лапочка - палочка
дата - адат
отвычка - выточка
мустанг - мангуст
отрезок - креозот
спикер - персик
маточник - намотчик
апельсин - спаниель
варан - навар
своё - овёс
квинта - ватник
спил - плис
гора - арго
нагораживание - ангажирование
горб - гроб
пронимание - проминание
аванс - саван
парх - прах
псалтырь - пластырь
кардан - дранка
парс - рапс
сура - раус
декор - докер
масон - осман
парк - карп
леер - реле
пард - драп
акустика - каустика
пара - арап
кавитация - активация
морилка - рамолик
геометрия - геотермия
переламывание - перемалывание
хна - хан
колпик - клопик
тонировка - кротовина
палка - лапка
гимнаст - нистагм
пошлячка - шляпочка
терн - трен
постель - топсель
бельмо - бемоль
резеда - дереза
префект - перфект
шуга - ашуг
отправка - автопарк
аорта - отара
частик - считка
балабон - балобан
будра - бурда
закол - золка
махра - хмара
соколик - колосик
градина - гардина
лопотун - полутон
мирон - минор
темка - макет
триба - барит
исток - стоик
нотирование - тонирование
амбра - амбар
разминка - кармазин
творило - ловитор
советчик - свиточек
фура - фрау
спец - сцеп
урна - руна
блюдолиз - лизоблюд
проуха - поруха
триас - сатир
сантим - самнит
аркан - накра
недокорм - комендор
пластание - палестина
поднизка - поздника
ракетка - каретка
жандарм - мандраж
кошт - шкот
ойкумена - неумойка
следование - совладение
дно - дон
дописка - диаскоп
тискание - скитание
круча - ручка
аконит - катион
хапание - пахание
бемоль - бельмо
пикон - пинок
масло - смола
касторка - красотка
оброк - борок
секач - сечка
тирада - триада
гробок - горбок
манго - гнома
работяга - горбатая
урок - укор
отрезка - розетка
урон - орун
теплица - петлица
хилость - лихость
печатка - аптечка
лопатник - лапотник
док - код
логопедия - педология
маска - камса
подрубка - продубка
сераль - рельса
урема - муаре
дон - дно
умбра - румба
порка - капор
кумач - мучка
полковник - клоповник
лавка - валка
росинка - соринка
сума - усма
клубничка - каблучник
тваринка - антиквар
наместник - сметанник
прокаливание - плакирование
дог - год
паля - пяла
отварка - автокар
кондор - кордон
пропарщик - прапорщик
мосье - сомье
ослёнок - лосёнок
марафет - фермата
конище - окнище
косина - осинка
руина - урина
блато - табло
закал - лазка
воструха - ухарство
радение - дарение
чаишко - ишачок
докалка - окладка
подчасок - подсачок
пудровка - продувка
робот - отбор
клико - колик
крикун - курник
сип - пси
тема - мета
оспинка - синкопа
сир - рис
пукля - купля
батник - бантик
роток - отрок
камус - сумка
древность - вредность
отбирание - обтирание
наливщик - лавинщик
соскок - скосок
муфта - фатум
монотипия - топонимия
приказ - каприз
тело - лето
вминание - внимание
остяк - стояк
будирование - обдуривание
валок - вокал
ворон - норов
кружка - куржак
антиномия - антимония
жарка - кража
герма - гарем
терно - тенор
ворог - говор
спорящий - просящий
рабство - барство
зело - злое
домна - номад
блонда - надолб
фашистка - фисташка
правота - потрава
лесопарк - пролеска
нирвана - равнина
чапельник - печальник
стокер - корсет
тюрк - трюк
навоз - вазон
кретон - корнет
навой - война
порченая - поречная
шпат - пшат
наречие - рачение
вощина - вонища
военкор - кровное
молоток - отломок
пересаливание - переслаивание
спурт - спрут
заток - отказ
пролом - промол
домра - морда
ледобур - ледоруб
приток - портик
акр - арк
забор - образ
акт - кат
коваль - альков
разливка - развилка
соколок - колосок
обдирание - добирание
стерно - сотерн
ирландка - кардинал
кадет - детка
клотик - отклик
этапирование - эпатирование
бокал - балок
вокалист - листовка
картошина - шкаторина
каустика - акустика
крапина - арапник
псина - синап
свет - вест
барство - рабство
ремесло - солемер
отпалка - лопатка
кариес - секира
лошадка - ладошка
сердцевина - древесница
сетка - аскет
ангажирование - нагораживание
папка - каппа
пралине - прелина
плетушка - теплушка
тоника - аконит
новатор - ровнота
пьекса - пьеска
тиверка - реактив
споровик - вопросик
алмазик - мазилка
шакал - алкаш
иприт - пирит
лошак - школа
провеивание - пивоварение
талышка - латышка
колоток - локоток
комната - намотка
расстание - срастание
выбор - обрыв
ранка - аркан
мурза - мазур
задний - дизайн
передраивание - передаривание
разводье - задворье
кутора - уторка
пантокрин - патронник
реагент - ренегат
септик - пестик
совладение - следование
бейсбол - бобслей
пасечник - песчаник
еврейка - верейка
селишко - лесишко
банту - бутан,     бан
влияние - виляние
истец - ситец
корт - крот
инока - икона
крупа - пурка
косность - носкость
корд - дрок
маячок - ямочка
пульсометр - полусмерть
катальщик - такальщик
недруг - дергун
поручение - упрочение
прутик - куприт
хряпа - пряха
чопорность - порочность
сон - нос
настилка - салатник
камса - маска
кураж - журка
перенос - пресное
сор - орс
бром - ромб
перемасливание - пересмаливание
сот - ост
тюха - юхта
артель - тарель
лачка - калач
манометр - метроман
арчинец - черница
телефотография - фототелеграфия
промеривание - премирование
влас - свал
притка - крипта
литка - талик
ротик - трико
аборт - обрат
будка - дубка
копа - капо
кретинка - каретник
палаш - лапша
теплушка - плетушка
выкат - тыква
толкун - колтун
китоловство - волокитство
обротка - отборка
горилка - рогалик
смола - масло
наймит - минтай
промасливание - просмаливание
писанка - испанка
половодь - водополь
заборчик - образчик
резон - зерно
сорит - ситро
